Kategória:Filozofia	"Filozofia"@sk
Kategória:Matematika	"Matematika"@sk
Kategória:Matematici	"Matematici"@sk
Kategória:Asertivita	"Asertivita"@sk
Kategória:Filozofické_smery	"Filozofické smery"@sk
Kategória:Filozofi	"Filozofi"@sk
Kategória:Mikroprocesory	"Mikroprocesory"@sk
Kategória:Krajiny_EÚ	"Krajiny EÚ"@sk
Kategória:Televízne_seriály	"Televízne seriály"@sk
Kategória:Bratislava	"Bratislava"@sk
Kategória:Žilina	"Žilina"@sk
Kategória:Anglickí_filmoví_herci	"Anglickí filmoví herci"@sk
Kategória:Českí_filmoví_herci	"Českí filmoví herci"@sk
Kategória:Francúzski_filmoví_herci	"Francúzski filmoví herci"@sk
Kategória:Slovenskí_filmoví_herci	"Slovenskí filmoví herci"@sk
Kategória:Talianski_filmoví_herci	"Talianski filmoví herci"@sk
Kategória:Filmoví_herci	"Filmoví herci"@sk
Kategória:Českí_filmoví_režiséri	"Českí filmoví režiséri"@sk
Kategória:Francúzski_filmoví_režiséri	"Francúzski filmoví režiséri"@sk
Kategória:Slovenskí_filmoví_režiséri	"Slovenskí filmoví režiséri"@sk
Kategória:Skladatelia_filmovej_hudby	"Skladatelia filmovej hudby"@sk
Kategória:Filmoví_režiséri	"Filmoví režiséri"@sk
Kategória:Scenáristi	"Scenáristi"@sk
Kategória:Hlavné_mestá	"Hlavné mestá"@sk
Kategória:Európske_mikroštáty	"Európske mikroštáty"@sk
Kategória:Monarchie	"Monarchie"@sk
Kategória:Vrchy	"Vrchy"@sk
Kategória:Rieky	"Rieky"@sk
Kategória:Ostrovy	"Ostrovy"@sk
Kategória:Televízne_relácie	"Televízne relácie"@sk
Kategória:Jazerá	"Jazerá"@sk
Kategória:Jazyky	"Jazyky"@sk
Kategória:Umelé_jazyky	"Umelé jazyky"@sk
Kategória:Existencialisti	"Existencialisti"@sk
Kategória:Roky	"Roky"@sk
Kategória:1990	"1990"@sk
Kategória:Filmy_z_1997	"Filmy z 1997"@sk
Kategória:1997	"1997"@sk
Kategória:90._roky_20._storočia	"90. roky 20. storočia"@sk
Kategória:20._storočie	"20. storočie"@sk
Kategória:1986	"1986"@sk
Kategória:80._roky_20._storočia	"80. roky 20. storočia"@sk
Kategória:1955	"1955"@sk
Kategória:50._roky_20._storočia	"50. roky 20. storočia"@sk